111111111111111111111
1C00000000000000000C1
100000000000000000001
100000000000000000001
10000000000000A000001
100000000000000000001
100000000000000000001
100000000000000000001
10000P000000000000001
100000000000000E00001
100000000000000000001
100000000000000000001
100000000000000000001
100000000000000000001
100000000000000000001
100000000000000000001
100000000000000000001
111111111111111111111