1111111111111
100100000Q0C1
1000011111001
1P0011E000000
1111111111111